"filename", "language", "Todo", "Dart", "comment", "blank", "total"
"d:\Flutterrrr\FlutterProjects\events_jo\lib\config\algorithms\image_for_string.dart", "Dart", 0, 102, 16, 16, 134
"d:\Flutterrrr\FlutterProjects\events_jo\lib\config\app.dart", "Dart", 0, 8, 5, 5, 18
"d:\Flutterrrr\FlutterProjects\events_jo\lib\config\enums\event_type.dart", "Dart", 0, 5, 0, 1, 6
"d:\Flutterrrr\FlutterProjects\events_jo\lib\config\enums\food_type.dart", "Dart", 0, 4, 0, 1, 5
"d:\Flutterrrr\FlutterProjects\events_jo\lib\config\enums\jordan_city.dart", "Dart", 0, 44, 0, 2, 46
"d:\Flutterrrr\FlutterProjects\events_jo\lib\config\enums\sort_direction.dart", "Dart", 0, 4, 0, 1, 5
"d:\Flutterrrr\FlutterProjects\events_jo\lib\config\enums\text_field_input_type.dart", "Dart", 0, 5, 0, 1, 6
"d:\Flutterrrr\FlutterProjects\events_jo\lib\config\enums\user type\user_type_enum.dart", "Dart", 0, -27, 0, -3, -30
"d:\Flutterrrr\FlutterProjects\events_jo\lib\config\enums\user type\user_type_gate.dart", "Dart", 0, -32, -1, -7, -40
"d:\Flutterrrr\FlutterProjects\events_jo\lib\config\enums\user_type_enum.dart", "Dart", 0, 27, 0, 3, 30
"d:\Flutterrrr\FlutterProjects\events_jo\lib\config\extensions\double_extensions.dart", "Dart", 0, 7, 0, 2, 9
"d:\Flutterrrr\FlutterProjects\events_jo\lib\config\extensions\string_extensions.dart", "Dart", 0, 35, 5, 9, 49
"d:\Flutterrrr\FlutterProjects\events_jo\lib\config\packages\from to picker\from_to_picker.dart", "Dart", 0, 655, 64, 46, 765
"d:\Flutterrrr\FlutterProjects\events_jo\lib\config\packages\from to picker\from_to_picker_colors.dart", "Dart", 0, 133, 13, 40, 186
"d:\Flutterrrr\FlutterProjects\events_jo\lib\config\packages\google navigation bar\alt_gbutton.dart", "Dart", 0, 203, 0, 13, 216
"d:\Flutterrrr\FlutterProjects\events_jo\lib\config\packages\google navigation bar\gbutton.dart", "Dart", 0, 111, 0, 5, 116
"d:\Flutterrrr\FlutterProjects\events_jo\lib\config\packages\google navigation bar\gnav.dart", "Dart", 0, 138, 0, 12, 150
"d:\Flutterrrr\FlutterProjects\events_jo\lib\config\packages\image slideshow\image_slideshow.dart", "Dart", 0, 150, 17, 28, 195
"d:\Flutterrrr\FlutterProjects\events_jo\lib\config\packages\image slideshow\indicator.dart", "Dart", 0, 36, 0, 4, 40
"d:\Flutterrrr\FlutterProjects\events_jo\lib\config\packages\lazy indexed stack\lazy_indexed_stack.dart", "Dart", 0, 58, 9, 14, 81
"d:\Flutterrrr\FlutterProjects\events_jo\lib\config\packages\string similarity\best_match.dart", "Dart", 0, 12, 4, 6, 22
"d:\Flutterrrr\FlutterProjects\events_jo\lib\config\packages\string similarity\rating.dart", "Dart", 0, 7, 3, 4, 14
"d:\Flutterrrr\FlutterProjects\events_jo\lib\config\packages\string similarity\string_similarity.dart", "Dart", 0, 65, 30, 12, 107
"d:\Flutterrrr\FlutterProjects\events_jo\lib\config\utils\custom_icons_icons.dart", "Dart", 0, 26, 0, 0, 26
"d:\Flutterrrr\FlutterProjects\events_jo\lib\config\utils\delay.dart", "Dart", 0, 14, 0, 4, 18
"d:\Flutterrrr\FlutterProjects\events_jo\lib\config\utils\global_colors.dart", "Dart", 0, 1, -9, -1, -9
"d:\Flutterrrr\FlutterProjects\events_jo\lib\config\utils\global_snack_bar.dart", "Dart", 0, 16, 1, 0, 17
"d:\Flutterrrr\FlutterProjects\events_jo\lib\config\utils\gradient\gradient_icon.dart", "Dart", 0, 70, 8, 12, 90
"d:\Flutterrrr\FlutterProjects\events_jo\lib\config\utils\identical_objects.dart", "Dart", 0, 110, 7, 13, 130
"d:\Flutterrrr\FlutterProjects\events_jo\lib\eventsjo_todos.todo", "Todo", 79, 0, 0, 3, 82
"d:\Flutterrrr\FlutterProjects\events_jo\lib\features\admin\data\firebase_admin_repo.dart", "Dart", 0, 20, 8, 3, 31
"d:\Flutterrrr\FlutterProjects\events_jo\lib\features\admin\presentation\components\admin_app_bar.dart", "Dart", 0, -3, 0, 0, -3
"d:\Flutterrrr\FlutterProjects\events_jo\lib\features\admin\presentation\components\admin_button.dart", "Dart", 0, 2, 0, 0, 2
"d:\Flutterrrr\FlutterProjects\events_jo\lib\features\admin\presentation\components\admin_card.dart", "Dart", 0, 1, 0, 0, 1
"d:\Flutterrrr\FlutterProjects\events_jo\lib\features\admin\presentation\components\admin_card_dashboard.dart", "Dart", 0, -80, 0, -4, -84
"d:\Flutterrrr\FlutterProjects\events_jo\lib\features\admin\presentation\components\admin_card_events.dart", "Dart", 0, -80, 0, -4, -84
"d:\Flutterrrr\FlutterProjects\events_jo\lib\features\admin\presentation\components\admin_dashboard_card.dart", "Dart", 0, 80, 0, 4, 84
"d:\Flutterrrr\FlutterProjects\events_jo\lib\features\admin\presentation\components\admin_event_list_loading_card.dart", "Dart", 0, 27, 0, 3, 30
"d:\Flutterrrr\FlutterProjects\events_jo\lib\features\admin\presentation\components\admin_events_card.dart", "Dart", 0, 11, 0, 0, 11
"d:\Flutterrrr\FlutterProjects\events_jo\lib\features\admin\presentation\components\admin_home_card.dart", "Dart", 0, 81, 0, 4, 85
"d:\Flutterrrr\FlutterProjects\events_jo\lib\features\admin\presentation\components\admin_loading_card.dart", "Dart", 0, 47, 0, 0, 47
"d:\Flutterrrr\FlutterProjects\events_jo\lib\features\admin\presentation\components\admin_loading_users_card.dart", "Dart", 0, 22, 0, 3, 25
"d:\Flutterrrr\FlutterProjects\events_jo\lib\features\admin\presentation\components\admin_sub_app_bar.dart", "Dart", 0, 3, 0, 0, 3
"d:\Flutterrrr\FlutterProjects\events_jo\lib\features\admin\presentation\components\admin_users_card.dart", "Dart", 0, 3, 0, 0, 3
"d:\Flutterrrr\FlutterProjects\events_jo\lib\features\admin\presentation\components\approved venues\admin_approved_venue_summary.dart", "Dart", 0, 15, 1, 3, 19
"d:\Flutterrrr\FlutterProjects\events_jo\lib\features\admin\presentation\components\menu_tab_bar.dart", "Dart", 0, 6, 0, 0, 6
"d:\Flutterrrr\FlutterProjects\events_jo\lib\features\admin\presentation\components\no_requests_left.dart", "Dart", 0, -4, 0, -1, -5
"d:\Flutterrrr\FlutterProjects\events_jo\lib\features\admin\presentation\components\unapproved venues\admin_unapproved_venue_summary.dart", "Dart", 0, 15, 1, 3, 19
"d:\Flutterrrr\FlutterProjects\events_jo\lib\features\admin\presentation\components\users\admin_user_summary.dart", "Dart", 0, -7, -1, -2, -10
"d:\Flutterrrr\FlutterProjects\events_jo\lib\features\admin\presentation\cubits\single venue\admin_single_venue_cubit.dart", "Dart", 0, -75, -2, -9, -86
"d:\Flutterrrr\FlutterProjects\events_jo\lib\features\admin\presentation\cubits\venues\approve\admin_approve_cubit.dart", "Dart", 0, 3, 0, 4, 7
"d:\Flutterrrr\FlutterProjects\events_jo\lib\features\admin\presentation\cubits\venues\unapprove\admin_unapprove_cubit.dart", "Dart", 0, -6, 0, 3, -3
"d:\Flutterrrr\FlutterProjects\events_jo\lib\features\admin\presentation\pages\admin_page_for_venues.dart", "Dart", 0, 9, -1, 5, 13
"d:\Flutterrrr\FlutterProjects\events_jo\lib\features\admin\presentation\pages\owners\admin_owner_details_page.dart", "Dart", 0, -14, -2, -2, -18
"d:\Flutterrrr\FlutterProjects\events_jo\lib\features\admin\presentation\pages\owners\admin_owners_list_page.dart", "Dart", 0, 7, 0, 0, 7
"d:\Flutterrrr\FlutterProjects\events_jo\lib\features\admin\presentation\pages\users\admin_user_details_page.dart", "Dart", 0, -14, -2, -2, -18
"d:\Flutterrrr\FlutterProjects\events_jo\lib\features\admin\presentation\pages\users\admin_users_list_page.dart", "Dart", 0, 7, 0, 0, 7
"d:\Flutterrrr\FlutterProjects\events_jo\lib\features\admin\presentation\pages\venues\approved\admin_approved_venue_details.dart", "Dart", 0, -4, 0, 0, -4
"d:\Flutterrrr\FlutterProjects\events_jo\lib\features\admin\presentation\pages\venues\approved\admin_approved_venues.dart", "Dart", 0, 3, 0, 0, 3
"d:\Flutterrrr\FlutterProjects\events_jo\lib\features\admin\presentation\pages\venues\unapproved\admin_unapproved_venue_details.dart", "Dart", 0, 4, 6, 8, 18
"d:\Flutterrrr\FlutterProjects\events_jo\lib\features\admin\presentation\pages\venues\unapproved\admin_unapproved_venues.dart", "Dart", 0, 7, 0, 0, 7
"d:\Flutterrrr\FlutterProjects\events_jo\lib\features\auth\data\firebase_auth_repo.dart", "Dart", 0, 9, 0, 0, 9
"d:\Flutterrrr\FlutterProjects\events_jo\lib\features\auth\domain\entities\app_user.dart", "Dart", 0, 0, 0, -2, -2
"d:\Flutterrrr\FlutterProjects\events_jo\lib\features\auth\domain\entities\user_manager.dart", "Dart", 0, 13, 0, 6, 19
"d:\Flutterrrr\FlutterProjects\events_jo\lib\features\auth\domain\repos\auth_repo.dart", "Dart", 0, 6, -2, -1, 3
"d:\Flutterrrr\FlutterProjects\events_jo\lib\features\auth\representation\components\auth_button.dart", "Dart", 0, 0, -1, 1, 0
"d:\Flutterrrr\FlutterProjects\events_jo\lib\features\auth\representation\components\auth_text_field.dart", "Dart", 0, 8, 0, 3, 11
"d:\Flutterrrr\FlutterProjects\events_jo\lib\features\auth\representation\components\change_user_type_row.dart", "Dart", 0, 30, 0, 0, 30
"d:\Flutterrrr\FlutterProjects\events_jo\lib\features\auth\representation\cubits\auth_cubit.dart", "Dart", 0, 96, 15, 20, 131
"d:\Flutterrrr\FlutterProjects\events_jo\lib\features\auth\representation\cubits\auth_states.dart", "Dart", 0, 0, 0, -1, -1
"d:\Flutterrrr\FlutterProjects\events_jo\lib\features\auth\representation\pages\login_page.dart", "Dart", 0, 1, 0, 1, 2
"d:\Flutterrrr\FlutterProjects\events_jo\lib\features\auth\representation\pages\register_page.dart", "Dart", 0, -26, -4, -5, -35
"d:\Flutterrrr\FlutterProjects\events_jo\lib\features\auth\representation\pages\user_type_gate.dart", "Dart", 0, 31, 1, 7, 39
"d:\Flutterrrr\FlutterProjects\events_jo\lib\features\home\presentation\components\app_bar_button.dart", "Dart", 0, 50, 0, 3, 53
"d:\Flutterrrr\FlutterProjects\events_jo\lib\features\home\presentation\components\appbar_button.dart", "Dart", 0, -50, 0, -3, -53
"d:\Flutterrrr\FlutterProjects\events_jo\lib\features\home\presentation\components\events_jo_logo.dart", "Dart", 0, -1, 0, 0, -1
"d:\Flutterrrr\FlutterProjects\events_jo\lib\features\home\presentation\components\home_app_bar.dart", "Dart", 0, 46, 0, 5, 51
"d:\Flutterrrr\FlutterProjects\events_jo\lib\features\home\presentation\components\home_card.dart", "Dart", 0, 0, 0, 1, 1
"d:\Flutterrrr\FlutterProjects\events_jo\lib\features\home\presentation\components\owner_button.dart", "Dart", 0, -70, 0, -4, -74
"d:\Flutterrrr\FlutterProjects\events_jo\lib\features\home\presentation\pages\home_page.dart", "Dart", 0, 11, 2, 5, 18
"d:\Flutterrrr\FlutterProjects\events_jo\lib\features\home\presentation\pages\home_page_for_admins.dart", "Dart", 0, 4, 1, 2, 7
"d:\Flutterrrr\FlutterProjects\events_jo\lib\features\home\presentation\pages\home_page_for_owners.dart", "Dart", 0, 10, -12, 3, 1
"d:\Flutterrrr\FlutterProjects\events_jo\lib\features\location\domain\entities\ej_location.dart", "Dart", 0, 28, 29, 4, 61
"d:\Flutterrrr\FlutterProjects\events_jo\lib\features\location\domain\entities\user_location.dart", "Dart", 0, -15, -29, -4, -48
"d:\Flutterrrr\FlutterProjects\events_jo\lib\features\location\representation\cubits\location_cubit.dart", "Dart", 0, 32, 7, 5, 44
"d:\Flutterrrr\FlutterProjects\events_jo\lib\features\navigation\presentation\global_navigation_bar.dart", "Dart", 0, -10, 0, -2, -12
"d:\Flutterrrr\FlutterProjects\events_jo\lib\features\navigation\presentation\global_navigation_bar_for_admins.dart", "Dart", 0, -2, -1, -2, -5
"d:\Flutterrrr\FlutterProjects\events_jo\lib\features\navigation\presentation\global_navigation_bar_for_owners.dart", "Dart", 0, -10, 0, -2, -12
"d:\Flutterrrr\FlutterProjects\events_jo\lib\features\owner\data\firebase_owner_repo.dart", "Dart", 0, 1, -1, 1, 1
"d:\Flutterrrr\FlutterProjects\events_jo\lib\features\owner\domain\repo\owner_repo.dart", "Dart", 0, 1, 0, 1, 2
"d:\Flutterrrr\FlutterProjects\events_jo\lib\features\owner\representation\components\date_picker.dart", "Dart", 0, -44, -5, -3, -52
"d:\Flutterrrr\FlutterProjects\events_jo\lib\features\owner\representation\components\dialogs\food_on_tap_dialog.dart", "Dart", 0, 70, 7, 4, 81
"d:\Flutterrrr\FlutterProjects\events_jo\lib\features\owner\representation\components\food_card.dart", "Dart", 0, 55, 2, 4, 61
"d:\Flutterrrr\FlutterProjects\events_jo\lib\features\owner\representation\components\owner_app_bar.dart", "Dart", 0, 12, 2, 1, 15
"d:\Flutterrrr\FlutterProjects\events_jo\lib\features\owner\representation\components\owner_button.dart", "Dart", 0, 70, 0, 4, 74
"d:\Flutterrrr\FlutterProjects\events_jo\lib\features\owner\representation\components\owner_drink_card.dart", "Dart", 0, 0, -1, 0, -1
"d:\Flutterrrr\FlutterProjects\events_jo\lib\features\owner\representation\components\owner_meal_card.dart", "Dart", 0, 0, -1, 0, -1
"d:\Flutterrrr\FlutterProjects\events_jo\lib\features\owner\representation\components\owner_page_bar.dart", "Dart", 0, -2, 0, 0, -2
"d:\Flutterrrr\FlutterProjects\events_jo\lib\features\owner\representation\components\owner_page_bar_handler.dart", "Dart", 0, -43, -2, -4, -49
"d:\Flutterrrr\FlutterProjects\events_jo\lib\features\owner\representation\components\owner_page_navigation_bar.dart", "Dart", 0, 1, 0, 0, 1
"d:\Flutterrrr\FlutterProjects\events_jo\lib\features\owner\representation\components\time_picker.dart", "Dart", 0, -35, -1, -3, -39
"d:\Flutterrrr\FlutterProjects\events_jo\lib\features\owner\representation\cubits\owner_cubit.dart", "Dart", 0, 0, 0, -1, -1
"d:\Flutterrrr\FlutterProjects\events_jo\lib\features\owner\representation\pages\owner_page.dart", "Dart", 0, 13, 9, 10, 32
"d:\Flutterrrr\FlutterProjects\events_jo\lib\features\owner\representation\pages\sub pages\confirm_and_add_event_to_database_page.dart", "Dart", 0, -163, -15, -23, -201
"d:\Flutterrrr\FlutterProjects\events_jo\lib\features\owner\representation\pages\sub pages\confirm_event_page.dart", "Dart", 0, 177, 14, 27, 218
"d:\Flutterrrr\FlutterProjects\events_jo\lib\features\owner\representation\pages\sub pages\event_added_successfully_page.dart", "Dart", 0, 4, 0, 0, 4
"d:\Flutterrrr\FlutterProjects\events_jo\lib\features\owner\representation\pages\sub pages\select_event_drinks.dart", "Dart", 0, -137, -6, -11, -154
"d:\Flutterrrr\FlutterProjects\events_jo\lib\features\owner\representation\pages\sub pages\select_event_drinks_page.dart", "Dart", 0, 214, 6, 15, 235
"d:\Flutterrrr\FlutterProjects\events_jo\lib\features\owner\representation\pages\sub pages\select_event_location_page.dart", "Dart", 0, 4, 0, 3, 7
"d:\Flutterrrr\FlutterProjects\events_jo\lib\features\owner\representation\pages\sub pages\select_event_meals.dart", "Dart", 0, -139, -6, -11, -156
"d:\Flutterrrr\FlutterProjects\events_jo\lib\features\owner\representation\pages\sub pages\select_event_meals_page.dart", "Dart", 0, 216, 6, 14, 236
"d:\Flutterrrr\FlutterProjects\events_jo\lib\features\owner\representation\pages\sub pages\select_event_name_page.dart", "Dart", 0, 6, 0, 3, 9
"d:\Flutterrrr\FlutterProjects\events_jo\lib\features\owner\representation\pages\sub pages\select_event_type_page.dart", "Dart", 0, 12, -4, 2, 10
"d:\Flutterrrr\FlutterProjects\events_jo\lib\features\owner\representation\pages\sub pages\select_images_page.dart", "Dart", 0, -2, 0, 2, 0
"d:\Flutterrrr\FlutterProjects\events_jo\lib\features\owner\representation\pages\sub pages\select_license_page.dart", "Dart", 0, 62, 5, 9, 76
"d:\Flutterrrr\FlutterProjects\events_jo\lib\features\owner\representation\pages\sub pages\select_people_range.dart", "Dart", 0, 10, 0, 3, 13
"d:\Flutterrrr\FlutterProjects\events_jo\lib\features\owner\representation\pages\sub pages\select_range_date_page.dart", "Dart", 0, 30, 4, 2, 36
"d:\Flutterrrr\FlutterProjects\events_jo\lib\features\owner\representation\pages\sub pages\select_range_time_page.dart", "Dart", 0, -4, -1, -4, -9
"d:\Flutterrrr\FlutterProjects\events_jo\lib\features\settings\data\firebase_settings_repo.dart", "Dart", 0, 190, 48, 59, 297
"d:\Flutterrrr\FlutterProjects\events_jo\lib\features\settings\domain\settings_repo.dart", "Dart", 0, 15, 0, 7, 22
"d:\Flutterrrr\FlutterProjects\events_jo\lib\features\settings\representation\components\settings_card.dart", "Dart", 0, 50, 0, 4, 54
"d:\Flutterrrr\FlutterProjects\events_jo\lib\features\settings\representation\components\settings_divider.dart", "Dart", 0, 16, 0, 3, 19
"d:\Flutterrrr\FlutterProjects\events_jo\lib\features\settings\representation\components\settings_dropdown_field.dart", "Dart", 0, 77, 0, 4, 81
"d:\Flutterrrr\FlutterProjects\events_jo\lib\features\settings\representation\components\settings_icon_button.dart", "Dart", 0, 52, 0, 4, 56
"d:\Flutterrrr\FlutterProjects\events_jo\lib\features\settings\representation\components\settings_loading_button.dart", "Dart", 0, 45, 0, 4, 49
"d:\Flutterrrr\FlutterProjects\events_jo\lib\features\settings\representation\components\settings_sub_app_bar.dart", "Dart", 0, 35, 0, 5, 40
"d:\Flutterrrr\FlutterProjects\events_jo\lib\features\settings\representation\components\settings_switch.dart", "Dart", 0, 38, 0, 4, 42
"d:\Flutterrrr\FlutterProjects\events_jo\lib\features\settings\representation\components\settings_text_button.dart", "Dart", 0, 52, 0, 4, 56
"d:\Flutterrrr\FlutterProjects\events_jo\lib\features\settings\representation\components\settings_text_field.dart", "Dart", 0, 55, 0, 4, 59
"d:\Flutterrrr\FlutterProjects\events_jo\lib\features\settings\representation\cubits\email\email_cubit.dart", "Dart", 0, 22, 6, 7, 35
"d:\Flutterrrr\FlutterProjects\events_jo\lib\features\settings\representation\cubits\email\email_states.dart", "Dart", 0, 12, 0, 8, 20
"d:\Flutterrrr\FlutterProjects\events_jo\lib\features\settings\representation\cubits\password\password_cubit.dart", "Dart", 0, 21, 6, 7, 34
"d:\Flutterrrr\FlutterProjects\events_jo\lib\features\settings\representation\cubits\password\password_states.dart", "Dart", 0, 12, 0, 8, 20
"d:\Flutterrrr\FlutterProjects\events_jo\lib\features\settings\representation\cubits\settings_cubit.dart", "Dart", 0, 61, 11, 15, 87
"d:\Flutterrrr\FlutterProjects\events_jo\lib\features\settings\representation\cubits\settings_states.dart", "Dart", 0, 8, 0, 6, 14
"d:\Flutterrrr\FlutterProjects\events_jo\lib\features\settings\representation\pages\account_page.dart", "Dart", 0, 239, 29, 34, 302
"d:\Flutterrrr\FlutterProjects\events_jo\lib\features\settings\representation\pages\notifications_page.dart", "Dart", 0, 53, 4, 7, 64
"d:\Flutterrrr\FlutterProjects\events_jo\lib\features\settings\representation\pages\privacy_page.dart", "Dart", 0, 160, 10, 11, 181
"d:\Flutterrrr\FlutterProjects\events_jo\lib\features\settings\representation\pages\settings_page.dart", "Dart", 0, 119, 6, 14, 139
"d:\Flutterrrr\FlutterProjects\events_jo\lib\features\settings\representation\pages\settings_page_for_owners.dart", "Dart", 0, 151, 8, 20, 179
"d:\Flutterrrr\FlutterProjects\events_jo\lib\features\settings\representation\pages\sub pages\update_email_page.dart", "Dart", 0, 159, 19, 25, 203
"d:\Flutterrrr\FlutterProjects\events_jo\lib\features\settings\representation\pages\sub pages\update_password_page.dart", "Dart", 0, 152, 18, 23, 193
"d:\Flutterrrr\FlutterProjects\events_jo\lib\features\settings\representation\pages\support_page.dart", "Dart", 0, 152, 3, 10, 165
"d:\Flutterrrr\FlutterProjects\events_jo\lib\features\weddings\data\firebase_wedding_venue_drinks_repo.dart", "Dart", 0, -20, -4, -6, -30
"d:\Flutterrrr\FlutterProjects\events_jo\lib\features\weddings\data\firebase_wedding_venue_meals_repo.dart", "Dart", 0, -20, -4, -6, -30
"d:\Flutterrrr\FlutterProjects\events_jo\lib\features\weddings\data\firebase_wedding_venue_repo.dart", "Dart", 0, 39, 6, 7, 52
"d:\Flutterrrr\FlutterProjects\events_jo\lib\features\weddings\domain\entities\wedding_venue.dart", "Dart", 0, 4, 0, 0, 4
"d:\Flutterrrr\FlutterProjects\events_jo\lib\features\weddings\domain\repo\weddin_venue_drinks_repo.dart", "Dart", 0, -4, -1, -2, -7
"d:\Flutterrrr\FlutterProjects\events_jo\lib\features\weddings\domain\repo\wedding_venue_meals_repo.dart", "Dart", 0, -4, -1, -2, -7
"d:\Flutterrrr\FlutterProjects\events_jo\lib\features\weddings\domain\repo\wedding_venue_repo.dart", "Dart", 0, 7, 0, 4, 11
"d:\Flutterrrr\FlutterProjects\events_jo\lib\features\weddings\representation\components\details\venue_checkout_card.dart", "Dart", 0, 39, 1, 5, 45
"d:\Flutterrrr\FlutterProjects\events_jo\lib\features\weddings\representation\components\details\venue_date_picker.dart", "Dart", 0, 1, 0, 0, 1
"d:\Flutterrrr\FlutterProjects\events_jo\lib\features\weddings\representation\components\details\venue_details_summary.dart", "Dart", 0, 275, 3, 5, 283
"d:\Flutterrrr\FlutterProjects\events_jo\lib\features\weddings\representation\components\details\venue_name_rating_and_location.dart", "Dart", 0, 4, 0, 0, 4
"d:\Flutterrrr\FlutterProjects\events_jo\lib\features\weddings\representation\components\details\venue_people_slider.dart", "Dart", 0, -4, 0, -1, -5
"d:\Flutterrrr\FlutterProjects\events_jo\lib\features\weddings\representation\components\details\venue_time_picker.dart", "Dart", 0, 3, -29, 0, -26
"d:\Flutterrrr\FlutterProjects\events_jo\lib\features\weddings\representation\components\drink_card.dart", "Dart", 0, 10, 2, 2, 14
"d:\Flutterrrr\FlutterProjects\events_jo\lib\features\weddings\representation\components\empty_card.dart", "Dart", 0, 3, 0, 0, 3
"d:\Flutterrrr\FlutterProjects\events_jo\lib\features\weddings\representation\components\error_venues.dart", "Dart", 0, 37, 0, 4, 41
"d:\Flutterrrr\FlutterProjects\events_jo\lib\features\weddings\representation\components\meal_card.dart", "Dart", 0, 10, 2, 2, 14
"d:\Flutterrrr\FlutterProjects\events_jo\lib\features\weddings\representation\components\no_venues.dart", "Dart", 0, 37, 0, 4, 41
"d:\Flutterrrr\FlutterProjects\events_jo\lib\features\weddings\representation\components\venue_bar.dart", "Dart", 0, 111, 2, 5, 118
"d:\Flutterrrr\FlutterProjects\events_jo\lib\features\weddings\representation\components\venue_card.dart", "Dart", 0, 12, -2, 1, 11
"d:\Flutterrrr\FlutterProjects\events_jo\lib\features\weddings\representation\components\venue_changed.dart", "Dart", 0, 45, 0, 3, 48
"d:\Flutterrrr\FlutterProjects\events_jo\lib\features\weddings\representation\components\venue_search_bar.dart", "Dart", 0, 4, 0, 0, 4
"d:\Flutterrrr\FlutterProjects\events_jo\lib\features\weddings\representation\components\venue_search_bar_button.dart", "Dart", 0, 119, 4, 5, 128
"d:\Flutterrrr\FlutterProjects\events_jo\lib\features\weddings\representation\components\venues_app_bar.dart", "Dart", 0, 39, 0, 5, 44
"d:\Flutterrrr\FlutterProjects\events_jo\lib\features\weddings\representation\components\venues_list_loading.dart", "Dart", 0, 52, 2, 3, 57
"d:\Flutterrrr\FlutterProjects\events_jo\lib\features\weddings\representation\cubits\drinks\wedding_venue_meals_cubit.dart", "Dart", 0, -16, -1, -7, -24
"d:\Flutterrrr\FlutterProjects\events_jo\lib\features\weddings\representation\cubits\drinks\wedding_venue_meals_states.dart", "Dart", 0, -8, -4, -5, -17
"d:\Flutterrrr\FlutterProjects\events_jo\lib\features\weddings\representation\cubits\meals\wedding_venue_meals_cubit.dart", "Dart", 0, -15, -1, -7, -23
"d:\Flutterrrr\FlutterProjects\events_jo\lib\features\weddings\representation\cubits\meals\wedding_venue_meals_states.dart", "Dart", 0, -8, -4, -5, -17
"d:\Flutterrrr\FlutterProjects\events_jo\lib\features\weddings\representation\cubits\single venue\single_wedding_venue_cubit.dart", "Dart", 0, 110, 20, 23, 153
"d:\Flutterrrr\FlutterProjects\events_jo\lib\features\weddings\representation\cubits\single venue\single_wedding_venue_states.dart", "Dart", 0, 16, 5, 9, 30
"d:\Flutterrrr\FlutterProjects\events_jo\lib\features\weddings\representation\cubits\venue\wedding_venue_cubit.dart", "Dart", 0, -59, -23, -24, -106
"d:\Flutterrrr\FlutterProjects\events_jo\lib\features\weddings\representation\cubits\venue\wedding_venue_states.dart", "Dart", 0, -12, -4, -6, -22
"d:\Flutterrrr\FlutterProjects\events_jo\lib\features\weddings\representation\cubits\venues\wedding_venues_cubit.dart", "Dart", 0, 128, 42, 46, 216
"d:\Flutterrrr\FlutterProjects\events_jo\lib\features\weddings\representation\cubits\venues\wedding_venues_states.dart", "Dart", 0, 12, 4, 7, 23
"d:\Flutterrrr\FlutterProjects\events_jo\lib\features\weddings\representation\pages\wedding_venues_details_page.dart", "Dart", 0, -43, -18, -7, -68
"d:\Flutterrrr\FlutterProjects\events_jo\lib\features\weddings\representation\pages\wedding_venues_page.dart", "Dart", 0, 21, 7, 1, 29
"d:\Flutterrrr\FlutterProjects\events_jo\lib\main.dart", "Dart", 0, 2, 1, 1, 4
"Total", "-", 79, 5526, 371, 711, 6687