"filename", "language", "Dart", "comment", "blank", "total"
"d:\Flutterrrr\FlutterProjects\events_jo\lib\config\app.dart", "Dart", 80, 18, 6, 104
"d:\Flutterrrr\FlutterProjects\events_jo\lib\config\custom_icons_icons.dart", "Dart", 26, 0, 4, 30
"d:\Flutterrrr\FlutterProjects\events_jo\lib\config\firebase_options.dart", "Dart", 71, 12, 7, 90
"d:\Flutterrrr\FlutterProjects\events_jo\lib\config\haversine.dart", "Dart", 40, 6, 11, 57
"d:\Flutterrrr\FlutterProjects\events_jo\lib\config\image_loading_indicator.dart", "Dart", 15, 0, 3, 18
"d:\Flutterrrr\FlutterProjects\events_jo\lib\config\loading_indicator.dart", "Dart", 15, 0, 3, 18
"d:\Flutterrrr\FlutterProjects\events_jo\lib\config\my_colors.dart", "Dart", 45, 10, 15, 70
"d:\Flutterrrr\FlutterProjects\events_jo\lib\features\auth\data\firebase_auth_repo.dart", "Dart", 146, 37, 49, 232
"d:\Flutterrrr\FlutterProjects\events_jo\lib\features\auth\domain\entities\app_user.dart", "Dart", 36, 2, 6, 44
"d:\Flutterrrr\FlutterProjects\events_jo\lib\features\auth\domain\repos\auth_repo.dart", "Dart", 9, 1, 7, 17
"d:\Flutterrrr\FlutterProjects\events_jo\lib\features\auth\representation\components\auth_button.dart", "Dart", 67, 1, 3, 71
"d:\Flutterrrr\FlutterProjects\events_jo\lib\features\auth\representation\components\auth_text_field.dart", "Dart", 54, 0, 3, 57
"d:\Flutterrrr\FlutterProjects\events_jo\lib\features\auth\representation\components\change_user_type_row.dart", "Dart", 66, 0, 4, 70
"d:\Flutterrrr\FlutterProjects\events_jo\lib\features\auth\representation\components\events_jo_logo_auth.dart", "Dart", 44, 0, 3, 47
"d:\Flutterrrr\FlutterProjects\events_jo\lib\features\auth\representation\cubits\auth_cubit.dart", "Dart", 61, 9, 13, 83
"d:\Flutterrrr\FlutterProjects\events_jo\lib\features\auth\representation\cubits\auth_states.dart", "Dart", 13, 6, 8, 27
"d:\Flutterrrr\FlutterProjects\events_jo\lib\features\auth\representation\pages\auth_page.dart", "Dart", 28, 0, 6, 34
"d:\Flutterrrr\FlutterProjects\events_jo\lib\features\auth\representation\pages\login_page.dart", "Dart", 119, 9, 11, 139
"d:\Flutterrrr\FlutterProjects\events_jo\lib\features\auth\representation\pages\register_page.dart", "Dart", 305, 26, 40, 371
"d:\Flutterrrr\FlutterProjects\events_jo\lib\features\home\presentation\components\appbar_button.dart", "Dart", 50, 0, 3, 53
"d:\Flutterrrr\FlutterProjects\events_jo\lib\features\home\presentation\components\events_jo_logo.dart", "Dart", 57, 1, 3, 61
"d:\Flutterrrr\FlutterProjects\events_jo\lib\features\home\presentation\components\gradient_text.dart", "Dart", 25, 0, 4, 29
"d:\Flutterrrr\FlutterProjects\events_jo\lib\features\home\presentation\components\home_card.dart", "Dart", 96, 9, 3, 108
"d:\Flutterrrr\FlutterProjects\events_jo\lib\features\home\presentation\components\home_card_temp.dart", "Dart", 88, 9, 4, 101
"d:\Flutterrrr\FlutterProjects\events_jo\lib\features\home\presentation\pages\home_page.dart", "Dart", 218, 99, 14, 331
"d:\Flutterrrr\FlutterProjects\events_jo\lib\features\location\data\geolocator_location_repo.dart", "Dart", 23, 3, 5, 31
"d:\Flutterrrr\FlutterProjects\events_jo\lib\features\location\domain\repo\location_repo.dart", "Dart", 4, 0, 2, 6
"d:\Flutterrrr\FlutterProjects\events_jo\lib\features\location\representation\components\location_loading_dialog.dart", "Dart", 54, 0, 2, 56
"d:\Flutterrrr\FlutterProjects\events_jo\lib\features\location\representation\components\location_provided_button.dart", "Dart", 66, 0, 3, 69
"d:\Flutterrrr\FlutterProjects\events_jo\lib\features\location\representation\components\map_dialog.dart", "Dart", 149, 5, 5, 159
"d:\Flutterrrr\FlutterProjects\events_jo\lib\features\location\representation\cubits\location_cubit.dart", "Dart", 25, 3, 9, 37
"d:\Flutterrrr\FlutterProjects\events_jo\lib\features\location\representation\cubits\location_states.dart", "Dart", 12, 4, 8, 24
"d:\Flutterrrr\FlutterProjects\events_jo\lib\features\navigation\presentation\navigation_bar.dart", "Dart", 92, 0, 7, 99
"d:\Flutterrrr\FlutterProjects\events_jo\lib\features\weddings\data\firebase_wedding_venue_repo.dart", "Dart", 19, 2, 6, 27
"d:\Flutterrrr\FlutterProjects\events_jo\lib\features\weddings\domain\entities\wedding_venue.dart", "Dart", 42, 2, 4, 48
"d:\Flutterrrr\FlutterProjects\events_jo\lib\features\weddings\domain\repo\wedding_venue_repo.dart", "Dart", 4, 1, 2, 7
"d:\Flutterrrr\FlutterProjects\events_jo\lib\features\weddings\representation\components\my_search_bar.dart", "Dart", 44, 2, 3, 49
"d:\Flutterrrr\FlutterProjects\events_jo\lib\features\weddings\representation\components\rating_venues.dart", "Dart", 49, 0, 3, 52
"d:\Flutterrrr\FlutterProjects\events_jo\lib\features\weddings\representation\components\wedding_venue_card.dart", "Dart", 167, 15, 6, 188
"d:\Flutterrrr\FlutterProjects\events_jo\lib\features\weddings\representation\cubits\wedding_venue_cubit.dart", "Dart", 47, 16, 21, 84
"d:\Flutterrrr\FlutterProjects\events_jo\lib\features\weddings\representation\cubits\wedding_venue_states.dart", "Dart", 13, 5, 7, 25
"d:\Flutterrrr\FlutterProjects\events_jo\lib\features\weddings\representation\pages\wedding_venues_detailes_page.dart", "Dart", 96, 11, 11, 118
"d:\Flutterrrr\FlutterProjects\events_jo\lib\features\weddings\representation\pages\wedding_venues_page.dart", "Dart", 114, 11, 9, 134
"d:\Flutterrrr\FlutterProjects\events_jo\lib\main.dart", "Dart", 13, 3, 5, 21
"Total", "-", 2807, 338, 351, 3496